Tukkka Rask	G
Anton Khudobin	G
Jimmy Howard	G
Jared Coreau	G
Henrik Lundqvist	G
Andre Pavelec	G
Frederik Anderson	G
Curtis McElhinney	G
Anders Bjoork	F
Brian Gionta	F
David Krejci	F
Ryan Donato	F
Zack Heinan	F
Jake DeBrusk	F
Brad Marchand	F
Rick Nash	F
Henrik Zetterberg	F
Tyler Bozak	F
Nazem Kadri	F
Curtis Brown	F
Kasperi Kapenen	F
Patrick Marleau	F
Leo Komorov	F
Mitch Marner	F
Auston Matthews	F
Andrew Jones	F
Gustav Nyquist	F
Tyler Bertuzzi	F
Anthony Mantha	F
Dylan Larkin	F
Darren Helm	F
Frans Neilson	F
Martin Frk	F
Matt Belesky	F
Pat Carey	F
Carl McLeod	F
Jasper Fast	F
Ryan Spooner	F
Peter Holland	F
Chris Kreider	F
Tom Gilmor	D
Marc Staal	D
Ryan Sproul	D
Bryan Sjei	D
Matt Reilly	D
Pat Zaitsev	D
Roman Polak	D
Ron Handsey	D
Jack Garntner	D
Sean Kemfer	D
Ryan O'Gara	D
Zdeno Chara	D
Brad Carlo	D
Charlie McAvoy	D
Adam McQuaid	D
Kirk Miller	D
Nick Holden	D
Trevor Daley	D
Dan Keiser	D
Mike Greeen	D
Nick Jensen	D
Nick Kronwall	D